00000000000000000000
11111111111111111111
10000001000141000001
10111100010100011101
10000111110111110001
10010101000100010111
11010101010101000131
10010501000101101101
10110101010100011001
10510101000111010011
11110001110101010011
11000100000100011001
11011101111100111101
11010000000000111101
12010110101010000001
11111111111111111111