00000000000000000000
11111111111111111111
14100010001011011101
10101010101010101001
10001000010051010001
11010101010101010101
10110100101000001001
10101010101010101001
11000000010000001501
11010101010101010101
10001000500101000001
10101010101010101101
10010010100100000101
11010101010001010101
13000111111111110021
11111111111111111111