00000000000000000000
11111111111111111111
12011100001100000011
11000001100000111011
10011111111110100011
10110000011110101111
10110111000115101151
10100100010111101101
10101101110110001101
10001101110110111101
11111000000000111101
10000011111110111101
10111115000010140001
10000011111010111101
11310000000010000001
11111111111111111111
