00000000000000000000
11111111111111111111
15001001100000010051
11001000001000000001
10100000010000011011
10001001000011000001
10001000010001001001
10001000000100011101
11111011111111011111
10000000200000000001
11111111110111110111
10000001000110000101
10011100010000111001
10010111110110000001
14110000010001111501
11111111111111111111