00000000000000000000
11111111111111111111
14500001111300000021
11111100001111111101
14100100001500000101
10100010001111101101
10111010001110001101
10100100000000111101
10000111111110101101
10011000000000101101
10010011111111100001
10010015000010001001
10010011111000010001
10011000011110000111
10000011000000000111
11111111111111111111